####################
#...|.............f#
0...|..............#
###.|#........b....#
#...|...##....b....#
#...|...#.#...-....#
#...|.@.#...#....s.#
#...|..........#####
0...|.......b..#^^^#
####################