####################
#...|.............f#
0...|..............#
###.|#........b....#
#...|...##....b....#
#...|...#.#...-....#
#...|...#...#....s.#
#...|.@........#####
0...|.0.....b..#^^^#
####################