####################
#..................#
#..................#
##...#.............#
#.......#.........b#
#...@.....#.......b#
#.........b.#......#
#..............#####
#..............#...#
####################