....................
####################
#..................#
#.@................#
#.................0#
########...#########
########^^^#########
####################
....................
....................