....................
....................
####################
#..................#
#.@...............0#
#.........##########
####################
....................
....................
....................