####################
#..................#
#..........b...b...#
#..................#
#.......#..........#
#...@..............#
#..................#
#.......############
#..................#
####################