####################
#                  #
#                  #
#                  #
#       #          #
#                  #
#                  #
#       ############
#@                 #
####################