####################
#...|..............#
0...|..............#
###.|#........b....#
#...|...#.....b...b#
#...|.....#...-...b#
#...|.......#......#
#...|..b...b...#####
0.@.|..b...-...#^^^#
####################