####################
#..................#
#s.................#
####################
#..................#
#..................#
#.................@#
#########...########
#0................p#
####################