....................
####################
#..................#
#.@................#
#.................0#
#..........#########
#...b......^^#######
####################
....................
....................