....................
####################
#.......#..........#
#.@.....#0.........#
#####...#....###...#
#.......##..b......#
#..############....#
#................###
#..............#####
#######^^#^^^#######