####################
#..................#
0..................#
##...#.............#
#.......#.........b#
#...@.....#.......b#
#.........b.#......#
#..............#####
#..............#...#
####################