####################
#..................#
#..................#
#..................#
#..................#
#..................#
#0................@#
####..#..#..#..#####
#.................p#
####################