####################
#...|..............#
0...|..............#
###.|#...p....b....#
#...|...##....b....#
#...|...#.#...-....#
#...|.@.#...#....p.#
#...|..........#####
0...|..........#^^^#
####################