###################
#                 #
#       #         #
#                 #
#               ###
# @               #
###################