####################
#..................#
#..................#
#..................#
#..................#
#..................#
#..................#
#...........b......#
#.....b^....bb....@#
####################