####################
#...|.............f#
0...|..............#
###.|#...p....b....#
#...|...##....b....#
#...|...#.#...-....#
#...|.@.#...#....ps#
#...|..........#####
0...|.......b..#^^^#
####################