####################
#...|..............#
#...|.............0#
#..||#####-......###
#.||...............#
#.|..........@.....#
#.|.........###....#
#.|................#
#####^^^...b.....p.#
####################