####################
#..................#
#....b.....b...b...#
#..................#
#.......#.....b....#
#...@..............#
#..................#
#.......############
#..................#
####################