####################
#..................#
#..................#
#..................#
#..................#
#..................#
#..................#
#...........b......#
#..p..b^^...bb....@#
####################