####################
#...........#......#
#..........0#......#
#.|...-...###......#
##|.....p...#......#
#....#######.....f.#
###......||........#
#########||.#......#
#s.....@..........s#
####################