####################
#..................#
#..................#
#..................#
#..................#
############.......#
#0.#.....||#......@#
#|##..###||##..#####
#|.......||.......p#
####################