####################
#..................#
#..................#
#..................#
#.....|.....-..###.#
######|..........#.#
#..@.#|..........#0#
#....##.......-...##
#..............#####
####################