####################
#..................#
#..................#
#..................#
#..................#
#..................#
#..@..............0#
#######.....-....###
#######^^^^^^^^^^###
####################