....................
....................
....................
####################
#.@................#
#.................0#
####################
....................
....................
....................