####################
#..................#
#..................#
#..................#
#..................#
#..................#
#..................#
#...........b......#
#.....b^^...bb....@#
####################