####################
#..................#
#0..||||||||||||...#
####........|||....#
#........||||......#
#......||||........#
#....|||...........#
#...||||||||||||...#
#.................@#
####################