####################
#..f...#.s.........#
########.###########
#........###########
#|................@#
#|##################
#|................0#
####################
....................
....................