####################
#..................#
0..................#
###..#........b....#
#.......#.....b...b#
#.........#...-...b#
#...........#......#
#......b...b...#####
#.@....b...-...#^^^#
####################