####################
#...|.....b........#
0...|..............#
###.|#........b....#
#...|...##....b...b#
#...|...#.#...-...b#
#...|.@.#f..#......#
#...|......b...#####
0...|......-..b#^^^#
####################