....................
####################
#..................#
#0.................#
####...............#
#.....##...........#
#.@.......##.......#
#..............#####
####################
....................