####################
#............s.....#
#0..bb.......####..#
######.b........#.@#
########.b......#||#
##########......#||#
###########.....#||#
############.....||#
#############......#
####################