####################
#.|................#
#.|########..#####.#
#.||#........#0....#
#||.#....f...#.#####
#|..##########.....#
#|................|#
##################|#
#@................|#
####################