####################
#..................#
#..................#
#.@.....0....|.....#
#.......#####|.....#
#............|.....#
#............|.....#
#............|.....#
#............|.....#
####################